222222222222222222-
441444144414441442-
141414141414141412-
141414141414141412-
141414141414141412-
141414141414141412-
141414141414141412-
144414441444144412-
222222222222222222-
222222222222222222
