44144414441442-
14141414141412-
14141414141412-
14141414141412-
14141414141412-
14141414141412-
14441444144412-
22222222222222